###################################################
#......#...................................#......#
#.#...#.#.................................#.#...#.#
#..#.#...#.............S...S.............#...#.#..#
#...#.....#.............................#.....#...#
#..........#...........................#..........#
#....##.....#.........................#.....##....#
#....##......#.....#...####...#......#......##....#
#.............#...#............#....#.............#
#........#.......#..............#........#........#
#.......#.................................#.......#
#......#########...................#########......#
#.....#.....................................#.....#
#....#..#.###############################.#..#....#
#.......#......#.....#......#.#.........#.#.......#
#.......######.#.##..###.#..#...#######.#.#.......#
#.......#..###.#..#....#.#..#....#...##.#.#.......#
#.......##........#..#...#.....#...#..#...#.......#
#.......###################################.......#
#.................................................#
#.................................................#
###################################################