############################################
#.....................#....................#
#.....................#....................#
#..........S..........#...........S........#
#.....................#....................#
#.....................#....................#
############################################
#..........................................#
#..................................#####...#
#..................................#...#...#
#..................................#...#...#
#.........#####....................#####...#
#.........#...#............................#
#.........#...#............................#
#.........#####.........#########..........#
#.......................#.......#..........#
#.......................#########..........#
#..........................................#
############################################