..................................
..................................
..............#####...............
.........S....#####....S..........
..............#####...............
..................................
..................................
