.......................########.............................#.
.......................########.............................#.
.......#...............########........................######.
.......#...............########..........#....................
.......#.................................#....................
.......#.................................#....................
...#################.....#...#...........#....................
...................#.....#...#...........#....................
...................#.....#...#...........#....................
...................#.....#...............#....................
........S.............####################...........S........
..............................................................
..............................................................
.#............######..........................................
.#...............#........................############........
.#...............#.......#................############........
.##..............#......#.#...................................
..##...................#...#..................................
...##.................#.....#.................................
....####..............##..##..................................
..............................................................