###############################
#............................S#
#.#############################
#.............................#
#############################.#
#.............................#
########......................#
#......#..........####........#
#......#..........####........#
#......#..........####......#.#
#..........................#..#
#...........#.............#...#
#...........#............#....#
#...........#...........#.....#
#...........#..........#......#
#...........#.........#####...#
#.............................#
#.#############################
#.............................#
#############################.#
#S............................#
###############################